======================================================================================================================================================
||                                                                                                                                                  ||
||                                                                                                                                                  ||
||                                                                                                                                                  ||
||                                                                                                                                                  ||
||                                                                                                                                                  ||
||                                                                                                                                                  ||
||                                                                                                                                                  ||
||                                                                                                                                                  ||
||                                                                                                                                                  ||
||                                                                                                                                                  ||
||                                                                                                                                                  ||
||                                                                                                                                                  ||
||                                                                                                                                                  ||
||                                                                                                                                                  ||
||                                                                                                                                                  ||
||                                                                                                                                                  ||
||                                                                                                                                                  ||
||                                                                                                                                                  ||
||                                                                                                                                                  ||
||                                                                                                                                                  ||
||                                                                                                                                                  ||
||                                                                                                                                                  ||
||                                                                                                                                                  ||
||                                                                                                                                                  ||
||                                                                                                                                                  ||
||                                                                                                                                                  ||
||                                                                                                                                                  ||
||                                                                                                                                                  ||
||                                                                                                                                                  ||
======================================================================================================================================================
||                                                                                                ||                                                ||
||                                                                                                ||                                                ||
||                                                                                                ||                                                ||
||                                                                                                ||                                                ||
||                                                                                                ||                                                ||
||                                                                                                ||                                                ||
||                                                                                                ||                                                ||
||                                                                                                ||                                                ||
======================================================================================================================================================